border_size=1
usage=map

Xos         , Xos         , Xos         , Xos         , Xos         , Xos         , Xos         , Xos         , Xos         , Xos         , Xos         , Xos         , Xos         , Xos         , Xos         , Xos         , Xos         , Xos         , Xos         , Xos         , Xos         
Xos         , Rr          , Rr          , Rr          , Rr          , Rr          , Rr          , Rr          , Rr          , Rr          , Rr          , Rr          , Rr          , Rr          , Rr          , Rr          , Rr          , Rr          , Rr          , Rr          , Xos         
Xos         , Rr          , Rr          , Rr          , Rr          , 1 Rr        , Rr          , Rr          , Rr          , Rr          , Rr          , Rr          , Rr          , Rr          , Rr          , Rr          , Rr          , Rr          , Rr          , Rr          , Xos         
Xos         , Rr          , Rr          , Rr          , Rr          , Rr          , Rr          , Rr          , Rr          , Rr          , Rr          , Rr          , Rr          , Rr          , Rr          , Rr          , Rr          , Rr          , Rr          , Rr          , Xos         
Xos         , Rr          , Rr          , Rr          , Rr          , Rr          , Rr          , Rr          , Rr          , Rr          , Rr          , Rr          , Rr          , Rr          , Rr          , Rr          , Rr          , Rr          , Rr          , Rr          , Xos         
Xos         , Rr          , Rr          , Rr          , Rr          , Rr          , Rr          , Rr          , Rr          , Rr          , Rr          , Rr          , Rr          , Rr          , Rr          , Rr          , Rr          , Rr          , Rr          , Rr          , Xos         
Xos         , Rr          , Rr          , Rr          , Rr          , Rr          , Rr          , Xv          , Rr          , Rr          , Rr          , Xv          , Rr          , Rr          , Rr          , Xv          , Rr          , Rr          , Rr          , Rr          , Xos         
Xos         , Rr          , Rr          , Rr          , Rr          , Rr          , Rr          , Xv          , Rr          , Rr          , Rr          , Xv          , Rr          , Rr          , Rr          , Xv          , Rr          , Rr          , Rr          , Rr          , Xos         
Xos         , Rr          , Rr          , Rr          , Rr          , Rr          , Rr          , Xv          , Rr          , Rr          , Rr          , Xv          , Rr          , Rr          , Rr          , Xv          , Rr          , Rr          , Rr          , Rr          , Xos         
Xos         , Rr          , Rr          , Rr          , Rr          , Rr          , Rr          , Xv          , Rr          , Rr          , Rr          , Xv          , Rr          , Rr          , Rr          , Xv          , Rr          , Rr          , Rr          , Rr          , Xos         
Xos         , Rr          , Rr          , Rr          , Rr          , Rr          , Rr          , Xv          , Rr          , Rr          , Rr          , Xv          , Rr          , Rr          , Rr          , Xv          , Rr          , Rr          , Rr          , Rr          , Xos         
Xos         , Rr          , Rr          , Rr          , Rr          , Rr          , Rr          , Xv          , Rr          , Rr          , Rr          , Xv          , Rr          , Rr          , Rr          , Xv          , Rr          , Rr          , Rr          , Rr          , Xos         
Xos         , Rr          , Rr          , Rr          , Rr          , Rr          , Rr          , Rr          , Rr          , Rr          , Rr          , Rr          , Rr          , Rr          , Rr          , Rr          , Rr          , Rr          , Rr          , Rr          , Xos         
Xos         , Rr          , Rr          , Rr          , Rr          , Rr          , Rr          , Rr          , Rr          , Rr          , Rr          , Rr          , Rr          , Rr          , Rr          , Rr          , Rr          , Rr          , Rr          , Rr          , Xos         
Xos         , Xos         , Xos         , Xos         , Xos         , Xos         , Xos         , Xos         , Xos         , Xos         , Xos         , Xos         , Xos         , Xos         , Xos         , Xos         , Xos         , Xos         , Xos         , Xos         , Xos         
