border_size=1
usage=map

Gs          , Gs          , Gs          , Gs          , Gs          , Gs          , Gs          , Gs          , Gs          , Gs          , Gs          , Gs          , Gg          , Gg          , Gg          , Rr          , Gg          , Gg          , Gg          , Gg          , Gg          , Gg          , Gg          , Gg          , Gg          , Gg          , Ggf         , Gg          , Gg          , Gg          , Gg          , Gg          , Gg          , Gg          , Gg          , Gg          , Gg          , Gg          , Gg          , Gg          , Gg          , Gg          , Rr          , Rr          
Gs          , Gs          , Gs          , Gs          , Gs          , Gs          , Gs          , Gs          , Gs          , Gs          , Gs          , Gs          , Gg          , Gg          , Gg          , Rr          , Gg          , Gg          , Gg          , Gg          , Gg          , Gg          , Gg          , Gg          , Gg          , Gg          , Ggf         , Gg          , Gg          , Gg          , Gg          , Gg          , Gg          , Gg          , Gg          , Gg          , Gg          , Gg          , Gg          , Gg          , Gg          , Gg          , Rr          , Rr          
Gs          , Gs          , Gs          , Gs          , Gs          , Gs          , Gs          , Gs          , Gs          , Gs          , Gs          , Gs          , Gg          , Gg^Vh       , Gg          , Rr          , Rr          , Gg          , Gg          , Gg          , Gg^Vh       , Gg          , Gg          , Gg          , Gg          , Gg          , Gg          , Gg          , Gg          , Gg          , Gg          , Gg          , Gg          , Ggf         , Gg          , Ggf         , Gg          , Gg          , Gg          , Ggf         , Rr          , Rr          , Gg          , Gg          
Gs          , Gs          , Gs          , Gs          , Gs          , Gs          , Gs          , Gs^Fp       , Gs^Fp       , Gs^Fp       , Gs          , Gs          , Re          , Gg          , Gg          , Gg          , Rr          , Gg          , Re^Gvs      , Gg          , Gg          , Gg          , Gg          , Gg          , Gg          , Gg          , Gg          , Gg          , Gg          , Ggf         , Gg          , Gg          , Ggf         , Gg          , Ggf         , Gg          , Gg          , Gg          , Rr          , Rr          , Gg          , Gg          , Ggf         , Ggf         
Gs          , Gs          , Gs          , Gs          , Gs          , Gs          , Gs          , Gs^Fp       , Gs^Fp       , Gs          , Gs          , Re^Gvs      , Aa          , Re          , Gg          , Gg          , Rr          , Gg          , Gg          , Re          , Re          , Gg          , Gg          , Gg          , Gg          , Gg          , Gg          , Gg          , Gg          , Gg          , Gg          , Gg          , Gg          , Gg          , Gg          , Gg          , Rr          , Rr          , Gg          , Gg          , Gg          , Gg          , Gg          , Gg          
Rr          , Rr          , Rr          , Gs          , Gs          , Gs          , Gs          , Gs^Fp       , Gs^Fp       , Gs          , Aa          , Aa          , Aa          , Gg          , Gg          , Gg          , Aa          , Aa          , Aa          , Aa          , Gg          , Gg          , Gg          , Gg          , Gg          , Gg          , Gg^Vh       , Gg          , Gg          , Gg          , Gg          , Ggf         , Gg          , Gg          , Rr          , Rr          , Gg          , Gg          , Gg          , Gg          , Gg          , Gg          , Gg          , Gg          
Gs          , Gs          , Gs          , Rr          , Rr          , Gs          , Gs          , Gs          , Gs          , Gs          , Gg          , Aa          , Gg          , Gg          , Gg          , Gg          , Rr          , Aa          , Aa          , Aa          , Aa          , Gg          , Gg          , Re^Gvs      , Re^Gvs      , Gg          , Gg          , Gg          , Gg          , Gg          , Gg          , Gg          , Rr          , Rr          , Gg          , Gg          , Ggf         , Gg          , Gg          , Gg          , Gg          , Gg          , Gg          , Gg          
Gs          , Gs          , Gs          , Gs          , Gs          , Rr          , Rr          , Gs          , Gg          , Gs          , Re          , Re^Gvs      , Re^Gvs      , Gg          , Gg          , Gg          , Rr          , Gg          , Chr         , Gg          , Gg          , Gg          , Re          , Gg          , Gg          , Re^Gvs      , Re^Gvs      , Gg          , Gg          , Ggf         , Rr          , Rr          , Gg          , Gg          , Gg          , Gg          , Gg          , Gg          , Gg          , Gg          , Gg          , Gg          , Gg          , Gg          
Gs          , Gs          , Gs          , Gs          , Gg          , Gg          , Gg          , Rr          , Rr          , Gg          , Gg          , Re          , Gg          , Gg          , Aa          , Gg          , Rr          , Chr         , Khr         , Aa          , Aa          , Re^Gvs      , Re          , Re          , Re          , Gg          , Gg          , Gg          , Rr          , Rr          , Gg          , Gg          , Gg          , Gg          , Ggf         , Gg          , Gg          , Gg          , Ggf         , Gg          , Gg          , Gg          , Gg          , Gg          
Gs          , Gs          , Gs          , Gs          , Gg          , Gs          , Gg          , Gg          , Gg^Vh       , Rr          , Aa          , Gg          , Aa          , Aa          , Aa          , Aa          , Rr          , Aa          , Chr         , Chr         , Aa          , Aa          , Aa          , Re^Gvs      , Gg          , Gg          , Rr          , Rr          , Gg          , Gg          , Re          , Gg          , Gg          , Gg          , Gg          , Gg          , Ggf         , Gg          , Ggf         , Gg          , Gg          , Ggf         , Gg          , Gg          
Gs^Fp       , Gs^Fp       , Gs          , 1 Gg        , Gg          , Gg          , Gg          , Gg          , Gg          , Gg          , Aa          , Aa          , Aa          , Aa          , Aa          , Aa          , Rr          , Gg          , Gg          , Aa          , Aa          , Aa          , Aa          , Gg          , Rr          , Rr          , Gg          , Aa          , Re^Gvs      , Re          , Re          , Re^Gvs      , Gg          , Gg          , Re          , Gg          , Gg          , Gg          , Gg          , Gg          , Gg          , Gg          , Gg          , Gg          
Gs^Fp       , Gs^Fp       , Gs^Fp       , Gs          , Gg          , Gg          , Gg          , Gg          , Re^Gvs      , Re          , Aa          , Aa          , Aa          , Aa          , Aa^Vha      , Aa^Vha      , Rr          , Gg          , Gg^Vh       , Gg          , Gg          , Gg          , Rr          , Rr          , Gg          , Gg          , Re          , Aa          , Gg          , Re          , Gg          , Gg          , Gg          , Re^Gvs      , Re          , Re          , Gg          , Gg          , Re^Gvs      , Re          , Gg          , Gg^Vh       , Gg          , Gg          
Gs^Fp       , Gs^Fp       , Gs^Fp       , Gs          , Gs          , Gg          , Gg          , Gg          , Gg          , Aa          , Aa          , Aa          , Aa^Vha      , Aa          , Ai          , Ai          , Ai          , Ww          , Ww          , Gg          , Rr          , Rr          , Gg          , Gg          , Re          , Re^Gvs      , Gg          , Gg          , Gg^Vh       , Gg          , Re          , Re          , Re^Gvs      , Gg          , Gg          , Gg          , Gg          , Gg          , Gg          , Re          , Re          , Gg          , Gg          , Gg          
Gs^Fp       , Gs^Fp       , Gs          , Gs          , Gg          , Gs          , Gg          , Aa          , Aa          , Aa          , Aa          , Aa          , Aa          , Ai          , Aa^Vha      , Aa          , Chr         , Aa^Vha      , Ww^Bw/      , Rr          , Gg^Vh       , Gg          , Gg          , Aa          , Gg          , Gg          , Re          , Gg          , Gg          , Gg          , Re^Gvs      , Re          , Gg          , Gg          , Re          , Gg          , Gg          , Gg          , Gg          , Gg          , Gg          , Gg          , Gg          , Gg          
Gs          , Gs          , Gs          , Gs          , Gg          , Gg          , Gg          , Gg          , Gg          , Gg          , Gg^Vh       , Gg          , Gg^Vh       , Ai          , Aa^Vha      , Chr         , Kh          , Aa          , Gg^Vh       , Ai          , Gg^Vh       , Gg^Vh       , Gg          , Aa          , Aa          , Re^Gvs      , Re          , Re          , Re^Gvs      , Gg          , Gg          , Gg          , Gg          , Re          , Re          , Re          , Gg          , Gg          , Gg          , Gg          , Gg          , Gg          , Gg          , Gg          
Gs          , Gs          , Gg          , Gg          , Aa          , Aa          , Chr         , Gg          , Gg          , Gg          , Gg          , Gg          , Gg          , Ai          , Ww^Bw/      , Aa          , Chr         , Aa          , Ww^Bw\      , Ai          , Rr          , Gg          , Gg          , Aa          , Aa          , Gg          , Gg          , Re^Gvs      , Gg          , Gg          , Gg          , Gg          , Gg          , Gg          , Gg          , Gg          , Gg          , Gg          , Gg          , Gg          , Gg          , Gg          , Gg          , Gg          
Gs          , Gs          , Gg          , Aa          , Chr         , Kh          , Aa          , Aa          , Aa          , Gg          , Aa^Vha      , Gg          , Rr          , Rr          , Ww          , Gg^Vh       , Rr          , Aa^Vha      , Ai          , Rr          , Gg          , Rr          , Rr          , Gg          , Gg          , Gg          , Gg          , Aa          , Aa          , Aa          , Aa          , Gg          , Gg          , Gg^Vh       , Gg          , Gg          , Gg          , Ww          , Ww          , Ww          , Ww          , Ww          , Ww          , Ww          
Gg          , Gg          , Gg          , Gg          , Gg          , Aa          , Gg          , Gg          , Aa          , Aa          , Aa          , Rr          , Gg          , Gg^Vh       , Gg          , Ai          , Ai          , Ai          , Aa^Vha      , Ai          , Ai          , Aa^Vha      , Gg          , Rr          , Rr          , Gg          , Aa          , Chr         , Kh          , Chr         , Aa          , Aa          , Ww          , Ww          , Ww          , Ww          , Ww          , Ww          , Ww          , Ww          , Ww          , Ww          , Ww          , Ww          
Gg          , Gg          , Gg          , Gg          , Gg          , Gg          , Gg          , Gg          , Rr          , Aa          , Aa          , Gg          , Aa          , Aa^Vha      , Aa          , Aa^Vha      , Gg          , Rr          , Gg          , Aa          , Ai          , Ai          , Ai          , Gg          , Aa          , Rr          , Aa          , Aa          , Chw         , Chw         , Ai          , Ww          , Ww          , Ww          , Ww          , Ww          , Ww          , Ww          , Ww          , Ww          , Ww          , Ww          , Ww          , Ww          
Gg          , Gg          , Gg          , Gg          , Gg          , Gg          , Rr          , Rr          , Gg          , Aa          , Aa          , Aa          , Aa          , Gg          , Gg          , Gg          , Gg          , Rr          , Rr          , Gg          , Gg          , Ai          , Ww          , Ww          , Ww          , Gg          , Ai          , Ww^Bw\      , Ai          , Ai          , Ww          , Ww          , Ww          , Ww          , Ww          , Ww          , Ww          , Ww          , Gg          , Gg          , Gg          , Gg          , Gg          , Gg          
Gg          , Gg          , Gg          , Gg          , Rr          , Rr          , Aa^Vha      , Aa          , Gg          , Gg          , Gg          , Aa          , Gg          , Gg          , Gg          , Gg          , Gg          , Gg          , Gg          , Rr          , Ai          , Ai          , Ai          , Ww          , Ww          , Ww          , Ww          , Ai          , Ww          , Ww          , Ww^Bw\      , Ww          , Gg          , Ww          , Gg          , Gg          , Gg          , Gg          , Gg          , Gg          , Gs^Fp       , Gs^Fp       , Gs^Fp       , Gs^Fp       
Gg          , Gg          , Rr          , Rr          , Gg          , Gg          , Gg          , Aa          , Gg          , Gg          , Gg          , Gg          , Gg          , Gg          , Ww          , Ww          , Ww          , Ww          , Ww          , Ww^Bw|      , Ww          , Ww          , Ai          , Ww          , Ww          , Ww          , Ww          , Ww          , Ww          , Gg^Vh       , Gg          , Rr          , Rr          , Gg          , Gg          , Gg          , Gs^Fp       , Gs^Fp       , Aa^Fpa      , Gs^Fp       , Aa^Fpa      , Gs^Fp       , Gs^Fp       , Gs^Fp       
Rr          , Rr          , Gg          , Gg          , Gg          , Gg          , Gg          , Gg          , Gg          , Gg          , Ww          , Ww          , Ww          , Ai          , Ai          , Ai          , Ai          , Ai          , Ww          , Ww          , Ww          , Ww          , Ww          , Ww          , Gg          , Gg          , Gg          , Gg          , Gg          , Gg          , Re          , Gg          , Gg          , Rr          , Rr          , Gg          , Gg          , Aa^Fpa      , Aa^Fpa      , Aa^Fpa      , Aa^Fpa      , Aa^Fpa      , Aa^Fpa      , Gs^Fp       
Gg          , Gg          , Gg          , Gg          , Gg          , Gg          , Gg          , Ww          , Ww          , Ww          , Ai          , Ai          , Ww          , Ai          , Ai          , Ai          , Ww          , Ww          , Gg          , Rr          , Gg          , Gg          , Gg          , Gg          , Gg          , Gg          , Aa          , Gg          , Gg          , Re          , Re          , Re          , Gg          , Gg          , Gg          , Rr          , Rr          , Gs          , Gg          , Gs^Fp       , Gs          , Aa^Fpa      , Gs^Fp       , Gs^Fp       
Gg          , Gg          , Ww          , Ww          , Ww          , Ww          , Ai          , Ai          , Ww          , Ww          , Ww          , Ai          , Ww          , Ww          , Gg          , Gg          , Gg          , Gg          , Gg          , Rr          , Gg          , Gg          , Gg          , Gg          , Gg          , Aa          , Gg          , Aa          , Aa          , Gg          , Aa          , Aa          , Gg          , Gg          , Gg          , Gg          , Gg          , Rr          , Rr          , Gs          , Gs          , Gs          , Gs          , Gs          
Ww          , Ww          , Ai          , Ai          , Ai          , Ww          , Ww          , Ai          , Ai          , Ww          , Gg          , Gg          , Gg          , Gg          , Gg          , Gg          , Gg          , Gg          , Gg          , Rr          , Rr          , Gg          , Gg          , Gg          , Gg          , Gg          , Gg          , Aa          , Aa          , Aa          , Gg          , Gg          , Gg          , Gg          , Gg          , Gg          , Gg          , Gs          , Gg          , Rr          , Rr          , Gs          , Gs          , Gs          
Ww          , Ww          , Ww          , Ww          , Ww          , Ww          , Ww          , Ai          , Ww          , Ww          , Gg          , Gg          , Gg          , Gg          , Gg          , Gg          , Gg          , Gg          , Gg          , Rr          , Rr          , Gg          , Gg          , Gg          , Gg          , Gg          , Gg          , Gg          , Gg          , Gg          , Gg          , Gg          , Gg          , Gg          , Gg          , Gg          , Gg          , Gs          , Gg          , Rr          , Rr          , Gs          , Gs          , Gs          
