border_size=1
usage=map

Xu          , Xu          , Xu          , Xu          , Xu          , Xu          , Xu          , Xu          , Xu          , Xu          , Xu          , Xu          , Xu          , Xu          , Xu          , Xu          , Ur          , Ur          , Xu          , Xu          , Xu          , Xu          , Qlf         , Uu          , Ur          , Uu          , Rp          , Uu          , Uu          , Ur          , Xu          , Xu          , Xu          , Xu          , Xu          , Xu          , Xu          , Xu          , Xu          , Xu          , Xu          , Xu          , Xu          , Xu          , Cud         , Xu          
Xu          , Xu          , Xu          , Xu          , Xu          , Xu          , Xu          , Xu          , Xu          , Xu          , Xu          , Xu          , Xu          , Xu          , Xu          , Xu          , Ur          , Ur          , Xu          , Xu          , Xu          , Xu          , Qlf         , Qlf         , Ur          , Rp          , Ur          , Ur          , Qlf         , Qlf         , Xu          , Xu          , Xu          , Ur          , Ur          , Xu          , Xu          , Xu          , Xu          , Xu          , Xu          , Xu          , Xu          , Xu          , Cud         , Cud         
Xu          , Xu          , Xu          , Xu          , Xu          , Xu          , Xu          , Xu          , Xu          , Xu          , Xu          , Xu          , Ur          , Xu          , Ur          , Ur          , Uu          , Xu          , Xu          , Xu          , Xu          , Xu          , Qlf         , Ur          , Ur          , Uu          , Ur          , Ur          , Qlf         , Xu          , Xu          , Xu          , Ur          , Ur          , Xu          , Uu          , Ur          , Xu          , Xu          , Xu          , Xu          , Xu          , Cud         , Cud         , Cud         , Cud         
Cud         , Xu          , Xu          , Xu          , Xu          , Xu          , Xu          , Xu          , Uu          , Ur          , Ur          , Ur          , Xu          , Ur          , Uu^Vud      , Ur          , Xu          , Xu          , Ur          , Xu          , Xu          , Xu          , Xu          , Qlf         , Uu          , Ur          , Ur          , Ur          , Ur          , Xu          , Uu^Vud      , Qlf         , Xu          , Xu          , Xu          , Xu          , Uu          , Xu          , Ur          , Uu          , Ur          , Xu          , Cud         , 7 Kud       , Xu          , Xu          
Cud         , Cud         , Cud         , Xu          , 6 Kud       , Xu          , Cud         , Cud         , Xu          , Ur          , Uu          , Xu          , Uh          , Xu          , Xu          , Ur          , Ur          , Uu          , Ur          , Uu          , Xu          , Xu          , Xu          , Uu          , Xu          , Qlf         , Uu          , Qlf         , Xu          , Ur          , Ur          , Uu          , Ur          , Xu          , Xu          , Xu          , Ur          , Ur          , Xu          , Xu          , Xu          , Cud         , Cud         , Cud         , Xu          , Xu          
Xu          , Cud         , Cud         , Cud         , Cud         , Cud         , Xu          , Xu          , Xu          , Xu          , Xu          , Uu          , Xu          , Uh          , Ur          , Uu          , Xu          , Xu          , Xu          , Ur          , Qlf         , Xu          , Uu          , Uu          , Xu          , Xu          , Uu          , Xu          , Xu          , Xu          , Xu          , Ur          , Uh          , Ur          , Qlf         , Uu          , Uu^Vu       , Xu          , Xu          , Xu          , Xu          , Cud         , Cud         , Xu          , Xu          , Xu          
Xu          , Xu          , Xu          , Xu          , Xu          , Cud         , Xu          , Xu          , Xu          , Xu          , Ur          , Xu          , Uh          , Ur          , Uu          , Xu          , Xu          , Xu          , Xu          , Xu          , Ur          , Uu          , Ur          , Xu          , Xu          , Xu          , Uu          , Xu          , Xu          , Xu          , Xu          , Xu          , Ur          , Qlf         , Xu          , Xu          , Uu          , Xu          , Xu          , Xu          , Xu          , Xu          , Cud         , Cud         , Xu          , Xu          
Xu          , Xu          , Xu          , Xu          , Xu          , Cud         , Xu          , Xu          , Ur          , Uh          , Xu          , Ur          , Xu          , Uu          , Ur          , Xu          , Uu          , Xu          , Xu          , Ur          , Xu          , Xu          , Xu          , Xu          , Xu          , Xu          , Ur          , Xu          , Xu          , Xu          , Ur          , Ur          , Ur          , Xu          , Xu          , Xu          , Xu          , Ur          , Uu          , Xu          , Uu          , Ur          , Ur          , Xu          , Xu          , Xu          
Xu          , Xu          , Xu          , Xu          , Xu          , Cud         , Xu          , Ur          , Xu          , Xu          , Xu          , Xu          , Ur          , Uu^Vu       , Xu          , Uu          , Ur          , Xu          , Ur          , Uu          , Ur          , Xu          , Uu          , Xu          , Uu          , Xu          , Ur          , Xu          , Ur          , Ur          , Uu          , Ur          , Xu          , Xu          , Xu          , Xu          , Uu          , Ur          , Xu          , Ur          , Xu          , Xu          , Ur          , Xu          , Xu          , Xu          
Xu          , Xu          , Xu          , Xu          , Xu          , Ur          , Ur          , Uh          , Ur          , Xu          , Ur          , Ur          , Xu          , Ur          , Xu          , Ur          , Xu          , Uu          , Xu          , Uu          , Xu          , Uu          , Xu          , Ur          , Xu          , Uu^Vu       , Ur          , Uu          , Xu          , Xu          , Xu          , Uu          , Ur          , Uu          , Uu^Vu       , Ur          , Ur          , Uu          , Xu          , Xu          , Ur          , Uu          , Xu          , Xu          , Xu          , Xu          
Xu          , Xu          , Xu          , Xu          , Xu          , Xu          , Aa^Cov      , Ur          , Xu          , Ur          , Xu          , Xu          , Ur          , Ur          , Xu          , Xu          , Xu          , Xu          , Uu          , Uu          , Ur          , Xu          , Xu          , Xu          , Xu          , Xu          , Uu          , Uu          , Xu          , Xu          , Xu          , Ur          , Xu          , Xu          , Ur          , Xu          , Xu          , Ur          , Ur          , Uh          , Ur          , Ur          , Xu          , Xu          , Xu          , Xu          
Xu          , Xu          , Aa^Cov      , Xu          , 9 Aa^Kov    , Aa^Cov      , Aa^Cov      , Xu          , Ur^Cov      , Uh          , Xu          , Xu          , Ur          , Ur          , Ur          , Xu          , Ur          , Uu          , Xu          , Xu          , Xu          , Ur          , Xu          , Xu          , Xu          , Ur          , Ur          , Xu          , Xu          , Xu          , Xu          , Ur          , Xu          , Ur          , Xu          , Xu          , Xu          , Ur          , Ur          , Uu          , Xu          , Ur          , Uu          , Xu          , Xu          , Xu          
Xu          , Xu          , Xu          , Aa^Cov      , Xu          , Aa^Cov      , Xu          , Aa^Cov      , Ur^Cov      , Xu          , Uu          , Uu          , Xu          , Xu          , Uu          , Ur          , Xu          , Ur          , Ur          , Xu          , Xu          , Xu          , Uu^Ii       , Uu^Ii       , Ur^Ii       , Ur^Ii       , Ur^Ii       , Xu          , Xu          , Xu          , Uu          , Ur          , Xu          , Uu          , Xu          , Xu          , Xu          , Xu          , Ur          , Xu          , Xu          , Ur          , Ur          , Xu          , Xu          , Xu          
Ur          , Xu          , Ur          , Xu          , Xu          , Aa^Cov      , Aa^Cov      , Aa^Cov      , Xu          , Ur          , Uu^Vud      , Uu          , Xu          , Xu          , Ur          , Uu          , Xu          , Xu          , Xu          , Uh          , Ur^Ii       , Ur^Ii       , Uu^Ii       , Ur^Ii       , Ur^Ii       , Ur^Ii       , Ur^Ii       , Ur^Ii       , Ur          , Xu          , Uu          , Xu          , Xu          , Ur          , Uu          , Xu          , Ur          , Ur          , Xu          , Xu          , Xu          , Xu          , Cud         , Cud         , Xu          , Xu          
Xu          , Ur          , Ur          , Aa^Cov      , Aa^Cov      , Aa^Cov      , Xu          , Xu          , Xu          , Ur          , Ur          , Ur          , Ur          , Xu          , Ur          , Xu          , Xu          , Xu          , Uu          , Ur^Ii       , Ur^Ii       , Uu^Ii       , Ur^Ii       , Ur^Ii       , Ur^Ii       , Ur^Ii       , Uu^Ii       , Ur^Ii       , Uu          , Xu          , Ur          , Xu          , Xu          , Ur          , Xu          , Ur          , Uu          , Uu          , Ur          , Ur          , Ur          , Xu          , Cud         , Cud         , Cud         , Xu          
Xu          , Xu          , Xu          , Xu          , Xu          , Uu          , Xu          , Xu          , Ur          , Uu          , Xu          , Xu          , Ur          , Uu          , Ur          , Xu          , Xu          , Xu          , Xu          , Uu^Ii       , Ur^Ii       , Uu^Ii       , Ur^Ii       , Ur^Ii       , Ur^Ii       , Ur^Ii       , Ur^Ii       , Xu          , Xu          , Ur          , Xu          , Ur          , Ur          , Xu          , Xu          , Xu          , Uu          , Xu          , Xu          , Ur          , Ur          , Cud         , Cud         , Cud         , 3 Kud       , Cud         
Xu          , Xu          , Xu          , Xu          , Xu          , Uu          , Ur          , Uh          , Ur          , Ur          , Uu          , Ur          , Xu          , Xu          , Ur          , Xu          , Ur          , Xu          , Xu          , Xu          , Uu^Ii       , Ur^Ii       , Ur^Ii       , Uu^Ii       , Ur^Ii       , Uu^Ii       , Ur^Ii       , Ur^Ii       , Xu          , Xu          , Xu          , Xu          , Uh          , Ur          , Ur          , Uu          , Xu          , Uu^Vu       , Uu          , Xu          , Xu          , Cud         , Xu          , Cud         , Cud         , Cud         
Xu          , Xu          , Xu          , Xu          , Ur          , Uu          , Xu          , Ur          , Xu          , Xu          , Xu          , Xu          , Xu          , Xu          , Xu          , Ur          , Ur          , Ur          , Uu          , Ur          , Ur^Ii       , Uu^Ii       , Ur^Ii       , Ur^Ii       , Ur^Ii       , Ur^Ii       , Ur^Ii       , Ur^Ii       , Xu          , Xu          , Xu          , Xu          , Ur          , Xu          , Xu          , Xu          , Xu          , Ur          , Ur          , Xu          , Uu          , Ur          , Xu          , Cud         , Xu          , Xu          
Xu          , Xu          , Xu          , Xu          , Uu          , Xu          , Xu          , Ur          , Xu          , Xu          , Xu          , Xu          , Xu          , Xu          , Ur          , Uu^Vud      , Xu          , Xu          , Xu          , Xu          , Ur^Ii       , Uu^Ii       , Ur^Ii       , Ur^Ii       , Ur^Ii       , Ur^Ii       , Uu^Ii       , Ur^Ii       , Xu          , Xu          , Uu          , Ur          , Ur          , Ur          , Uh          , Xu          , Ur          , Xu          , Ur          , Xu          , Ur          , Xu          , Uh          , Xu          , Xu          , Xu          
Xu          , Xu          , Xu          , Xu          , Xu          , Ur          , Uh          , Uu          , Uu          , Ur          , Uu^Vud      , Ur          , Ur          , Ur          , Uu          , Xu          , Xu          , Xu          , Xu          , Xu          , Ur          , Uu^Ii       , Uu^Ii       , Ur^Ii       , Ur^Ii       , Ur^Ii       , Ur^Ii       , Xu          , Uh          , Ur          , Uu          , Ur          , Xu          , Uu          , Xu          , Ur          , Xu          , Ur          , Ur          , Uu          , Xu          , Uu          , Ur          , Uu          , Xu          , Xu          
Xu          , Xu          , Xu          , Xu          , Xu          , Ur          , Xu          , Uu          , Xu          , Uu          , Xu          , Xu          , Xu          , Xu          , Uu          , Xu          , Ur          , Xu          , Xu          , Xu          , Uu          , Xu          , Xu          , Uu^Ii       , Uu^Ii       , Ur^Ii       , Ur^Ii       , Ur          , Ur          , Xu          , Xu          , Xu          , Xu          , Ur          , Xu          , Xu          , Xu          , Xu          , Ur          , Xu          , Uu          , Xu          , Uu          , Xu          , Xu          , Xu          
Cud         , Xu          , Cud         , Xu          , Cud         , Cud         , Cud         , Xu          , Xu          , Uu          , Xu          , Xu          , Xu          , Ur          , Ur          , Ur          , Xu          , Ur          , Uu          , Uu          , Uh          , Xu          , Xu          , Xu          , Xu          , Ur^Ii       , Xu          , Xu          , Xu          , Uu          , Xu          , Xu          , Xu          , Uh          , Ur          , Xu          , Uu          , Uu          , Uu          , Ur          , Xu          , Ur          , Xu          , Ur          , Xu          , Xu          
Cud         , Cud         , 4 Kud       , Cud         , Cud         , Cud         , Cud         , Xu          , Ur          , Ur          , Xu          , Xu          , Xu          , Ur          , Ur          , Xu          , Xu          , Xu          , Xu          , Ur          , Ur          , Xu          , Xu          , Xu          , Xu          , Ur          , Xu          , Xu          , Xu          , Uu          , Ur          , Xu          , Uu          , Uu          , Uu          , Ur          , Ur          , Xu          , Xu          , Xu          , Xu          , Xu          , Xu          , Uu          , Xu          , Xu          
Cud         , Cud         , Xu          , Cud         , Xu          , Cud         , Uu          , Ur          , Ur          , Uu          , Ur          , Xu          , Uu          , Ur          , Xu          , Uh          , Xu          , Xu          , Xu          , Xu          , Xu          , Ur          , Ur          , Xu          , Uu          , Ur          , Xu          , Xu          , Xu          , Uu          , Ur          , Uu^Vud      , Uu          , Xu          , Xu          , Xu          , Xu          , Uu          , Uu^Vu       , Xu          , Ur          , Xu          , Ur          , Ur          , Xu          , Xu          
Xu          , Xu          , Xu          , Xu          , Xu          , Xu          , Xu          , Ur          , Xu          , Xu          , Ur          , Ur          , Xu          , Xu          , Xu          , Uh          , Ur          , Xu          , Uu          , Xu          , Uu          , Uu          , Xu          , Uu^Vud      , Ur          , Xu          , Ur          , Uu          , Ur          , Ur          , Xu          , Uu          , Uu          , Ur          , Xu          , Xu          , Xu          , Ur          , Xu          , Ur          , Xu          , Uh          , Ur          , Ur          , Xu          , Xu          
Xu          , Xu          , Xu          , Xu          , Xu          , Xu          , Xu          , Ur          , Xu          , Xu          , Xu          , Uu          , Xu          , Xu          , Xu          , Uu          , Xu          , Uu          , Xu          , Ur          , Ur          , Xu          , Xu          , Xu          , Ur          , Uh          , Xu          , Xu          , Uu          , Xu          , Ur          , Xu          , Ur          , Uu          , Ur          , Ur          , Ur          , Ur          , Uh          , Uh          , Uh          , Ur          , Aa^Cov      , Aa^Cov      , Aa^Cov      , Xu          
Xu          , Xu          , Xu          , Xu          , Xu          , Xu          , Xu          , Uu          , Uu          , Xu          , Ur          , Uu^Vu       , Ur          , Ur          , Ur          , Uu          , Ur          , Xu          , Uu          , Xu          , Ur          , Uu          , Uu          , Ur          , Uu          , Xu          , Xu          , Ur          , Xu          , Ur          , Xu          , Ur          , Uh          , Xu          , Xu          , Ur          , Xu          , Uu          , Xu          , Ur          , Xu          , Xu          , Xu          , Xu          , Aa^Cov      , Xu          
Xu          , Xu          , Xu          , Xu          , Xu          , Xu          , Xu          , Xu          , Xu          , Uu          , Xu          , Xu          , Xu          , Xu          , Xu          , Xu          , Uu          , Ur          , Xu          , Uu          , Ur          , Xu          , Xu          , Xu          , Xu          , Uu^Vu       , Xu          , Xu          , Xu          , Xu          , Xu          , Xu          , Ur          , Xu          , Xu          , Uu          , Ur          , Ur          , Uu          , Ur          , Aa^Cov      , Xu          , Aa^Cov      , Aa^Cov      , 8 Ha^Kov    , Aa^Cov      
Xu          , Xu          , Xu          , Xu          , Xu          , Xu          , Xu          , Xu          , Xu          , Uu          , Ur          , Xu          , Xu          , Xu          , Ur          , Ur          , Xu          , Xu          , Ur          , Uu          , Xu          , Xu          , Xu          , Xu          , Xu          , Ur          , Xu          , Xu          , Uu          , Xu          , Uh          , Ur          , Xu          , Xu          , Xu          , Xu          , Xu          , Xu          , Ur          , Xu          , Xu          , Aa^Cov      , Aa^Cov      , Aa^Cov      , Aa^Cov      , Aa^Cov      
Xu          , Xu          , Xu          , Xu          , Xu          , Xu          , Xu          , Xu          , Xu          , Xu          , Cud         , Cud         , Xu          , Xu          , Ur          , Uu^Vud      , Ur          , Xu          , Xu          , Ur          , Uu          , Xu          , Uu          , Xu          , Uh          , Uu          , Uu          , Uu          , Xu          , Ur          , Xu          , Ur          , Ur          , Xu          , Xu          , Xu          , Uh          , Ur          , Xu          , Xu          , Xu          , Xu          , Xu          , Aa          , Aa^Cov      , Aa^Cov      
Xu          , Xu          , Xu          , Xu          , Xu          , Xu          , Xu          , Xu          , Cud         , Cud         , Xu          , Cud         , Uu          , Xu          , Ur          , Xu          , Ce          , Ce          , Ce          , Ce          , Xu          , Ur          , Xu          , Uu^Vu       , Xu          , Uu          , Cud         , Xu          , Xu          , Xu          , Xu          , Xu          , Cud         , Ur          , Uh          , Ur          , Xu          , Ur          , Xu          , Xu          , Xu          , Xu          , Xu          , Xu          , Xu          , Xu          
Xu          , Xu          , Xu          , Xu          , Xu          , Xu          , Cud         , Cud         , Cud         , Xu          , Xu          , Xu          , Uh          , Xu          , Uu          , Xu          , Xu          , Xu          , Ce          , Ce          , Ce          , Xu          , Xu          , Xu          , Xu          , Xu          , Cud         , Xu          , Xu          , Xu          , Cud         , Cud         , Xu          , Xu          , Xu          , Xu          , Xu          , Xu          , Xu          , Xu          , Xu          , Xu          , Xu          , Xu          , Xu          , Xu          
Xu          , Xu          , Xu          , Xu          , Xu          , 5 Kud       , Cud         , Cud         , Xu          , Xu          , Xu          , Xu          , Xu          , Ur          , Xu          , Xu          , Xu          , Xu          , Ce          , 1 Ke        , Ce          , Xu          , Xu          , Xu          , Xu          , Xu          , Xu          , Cud         , Cud         , Cud         , Cud         , Cud         , Xu          , Xu          , Xu          , Xu          , Xu          , Xu          , Xu          , Xu          , Xu          , Xu          , Xu          , Xu          , Xu          , Xu          
Xu          , Xu          , Xu          , Xu          , Xu          , Xu          , Cud         , Cud         , Xu          , Xu          , Xu          , Xu          , Xu          , Xu          , Xu          , Xu          , Xu          , Ce          , Ce          , Ce          , Xu          , Xu          , Xu          , Xu          , Xu          , Xu          , Xu          , Xu          , Cud         , 2 Kud       , Cud         , Xu          , Xu          , Xu          , Xu          , Xu          , Xu          , Xu          , Xu          , Xu          , Xu          , Xu          , Xu          , Xu          , Xu          , Xu          
Xu          , Xu          , Xu          , Xu          , Xu          , Xu          , Cud         , Cud         , Xu          , Xu          , Xu          , Xu          , Xu          , Xu          , Xu          , Xu          , Xu          , Xu          , Ce          , Ce          , Xu          , Xu          , Xu          , Xu          , Xu          , Xu          , Xu          , Cud         , Cud         , Cud         , Xu          , Xu          , Xu          , Xu          , Xu          , Xu          , Xu          , Xu          , Xu          , Xu          , Xu          , Xu          , Xu          , Xu          , Xu          , Xu          
